 0123456789AB
0............
1.█..███████.
2.█..█.....█.
3.█..█████.█.
4........█.█.
5.█......█.█.
6.██████.█.█.
7.█......█.█.
8.█.████.█.█.
9.█..........
